0*344******
011*677777*
0*2*6***:<*
0*2*68**:>*
*52*69;*:>*
******=?*>*
J*F*@@=*A>*
DDDDB*=****
*I**B*=CC**
*I*GB*=*EH/
