0*344******
011*67777;*
 *2*6***89*
 *2*6A**<:*
*52*DBC*=>*
******EF*?*
 *J*GGE*@?*
  IIH* ****
* ** *   **
* *  * *  /
