0*233*****
0*2*455558
0*2*4***67
0*2*****98
011*455*:;
**2*4*67*<
4*2*4*6*=<
33233*6***
****4*677*
55554*/***
