0*>??*****
1*>*@AAAAJ
1*>*@***BC
1*>*****ED
122*788*FG
**3*7*9:*H
=*3*7*9*IH
<<344*9***
****5*9;;*
66665*/***
