0*366*****
0*3*:<<<<C
0*3*:***?A
0*3*****DB
011*8==*EG
**2*8*>@*H
9*2*8*>*IH
55244*>***
****7*>FF*
;;;;7*/***
