  *************
              *
 * ********** *
 * *        * *
 * * ****** * *
 * *      * * *
 * ****** * * *
 *          * *
 *********  * *
 *         *  *
 *  ******** **
            * *
 ************ *
              /
***************
