 *   ***** *   ***** *   ***** *   ***** *   ***** *   *****
 * *       * *       * *       * *       * *       * *      
 * * ***   * * ***   * * ***   * * ***   * * ***   * * ***  
 * *****   * *****   * *****   * *****   * *****   * *****  
   *   *     *   *     *   *     *   *     *   *     *   *  
** * *  * ** * *  * ** * *  * ** * *  * ** * *  * ** * *  * 
 * * * *   * * * *   * * * *   * * * *   * * * *   * * * *  
     * ***     * ***     * ***     * ***     * ***     * ***
**** *   ***** *   ***** *   ***** *   ***** *   ***** *   *
     * ***     * ***     * ***     * ***     * ***     */***
